8,8,8,8,8,9,1,1,1,7,8,8,8,8,8,8
8,8,8,8,8,9,2,1,1,7,8,8,8,8,8,8
8,8,8,8,8,9,1,1,1,7,8,8,8,8,8,8
8,8,8,8,8,9,1,1,1,7,8,8,8,8,8,8
8,8,8,8,8,9,1,1,1,4,5,5,5,5,5,5
5,5,5,5,5,6,1,1,1,1,1,1,1,1,1,1
1,1,1,1,1,1,1,1,1,13,1,1,2,1,1,1
1,1,1,1,1,1,1,1,1,1,1,1,1,1,1,1
1,1,1,1,2,1,1,1,1,1,1,1,1,1,1,1
1,1,1,1,1,1,1,1,1,2,1,1,1,1,1,1
1,1,1,1,1,1,1,1,1,1,1,1,1,1,1,1
11,11,11,11,11,11,11,11,11,11,11,11,11,11,11